1111111
10P0001
100C001
1000001
1000001
1000E01
1000001
1111111