1111111111111111111
1000000000000000001
10P110000000C0C0001
10000000000000E0001
1111111111111111111
