111111111111111111111
100000000101011111111
100000000110000000001
100P00000100010111011
100000010000001100001
10000000010C00000E001
100000000100010000001
111111111111111111111
